//MAP CONVERTED BY dmm2tgm.py THIS HEADER COMMENT PREVENTS RECONVERSION, DO NOT REMOVE
"ab" = (
/obj/structure/table,
/obj/machinery/door/firedoor,
/turf/open/floor/iron/white/smooth_large,
/area/space)
"aQ" = (
/obj/effect/turf_decal/tile/yellow/opposingcorners,
/obj/machinery/chem_heater,
/turf/open/floor/iron/white,
/area/space)
"bd" = (
/obj/machinery/door/airlock/maintenance_hatch,
/turf/open/floor/plating,
/area/space)
"bN" = (
/obj/effect/turf_decal/tile/neutral{
	dir = 1
	},
/turf/open/floor/iron,
/area/space)
"dQ" = (
/obj/structure/rack/shelf,
/obj/item/gun/ballistic/automatic/pistol/sol/evil,
/obj/item/gun/ballistic/automatic/pistol/sol/evil,
/obj/item/gun/ballistic/automatic/pistol/sol/evil,
/turf/open/floor/mineral/plastitanium/red,
/area/space)
"dS" = (
/turf/open/floor/mineral/plastitanium,
/area/space)
"fh" = (
/obj/effect/turf_decal/tile/holiday/rainbow/opposingcorners,
/obj/machinery/smartfridge/organ,
/turf/open/floor/iron/white,
/area/space)
"fz" = (
/obj/machinery/door/airlock/grunge,
/turf/open/floor/iron/dark,
/area/space)
"gI" = (
/obj/machinery/computer/records/security/syndie{
	dir = 8
	},
/turf/open/floor/mineral/plastitanium,
/area/space)
"jI" = (
/obj/machinery/door/airlock/security/old,
/turf/open/floor/mineral/plastitanium,
/area/space)
"kr" = (
/obj/structure/table,
/obj/item/storage/medkit,
/obj/effect/turf_decal/bot_red,
/turf/open/floor/iron/white/smooth_large,
/area/space)
"ly" = (
/obj/structure/closet,
/turf/open/floor/iron/dark,
/area/space)
"lZ" = (
/obj/machinery/recharger,
/obj/structure/table,
/obj/item/gun/microfusion/mcr01,
/turf/open/floor/mineral/plastitanium/red,
/area/space)
"mD" = (
/obj/machinery/door/airlock/command/glass,
/turf/open/floor/iron/white/smooth_large,
/area/space)
"ne" = (
/obj/structure/table,
/turf/open/floor/mineral/plastitanium,
/area/space)
"nh" = (
/obj/effect/turf_decal/tile/yellow/opposingcorners,
/turf/open/floor/iron/white,
/area/space)
"oq" = (
/obj/structure/rack/shelf,
/obj/item/storage/medkit/toxin,
/obj/effect/turf_decal/bot_red,
/turf/open/floor/iron/white/smooth_large,
/area/space)
"oD" = (
/obj/structure/closet/crate/bin,
/turf/open/floor/iron,
/area/space)
"pP" = (
/obj/structure/chair/office/light{
	dir = 8
	},
/turf/open/floor/iron/dark,
/area/space)
"rj" = (
/turf/open/floor/iron/white/small,
/area/space)
"ss" = (
/obj/machinery/computer/crew/syndie{
	dir = 1
	},
/turf/open/floor/iron/dark,
/area/space)
"sH" = (
/obj/structure/chair/office/light,
/turf/open/floor/iron/dark,
/area/space)
"uj" = (
/obj/effect/turf_decal/tile/holiday/rainbow/opposingcorners,
/turf/open/floor/iron/white,
/area/space)
"up" = (
/obj/effect/turf_decal/tile/yellow/opposingcorners,
/obj/structure/table,
/turf/open/floor/iron/white,
/area/space)
"uX" = (
/obj/item/clothing/under/rank/security/officer/redsec,
/obj/item/clothing/under/rank/security/officer/redsec,
/obj/item/clothing/under/rank/security/officer/redsec,
/obj/item/clothing/suit/hooded/wintercoat/security/redsec,
/obj/item/clothing/suit/hooded/wintercoat/security/redsec,
/obj/item/clothing/suit/hooded/wintercoat/security/redsec,
/obj/item/clothing/shoes/jackboots/sec/redsec,
/obj/item/clothing/shoes/jackboots/sec/redsec,
/obj/structure/closet,
/turf/open/floor/mineral/plastitanium,
/area/space)
"va" = (
/obj/structure/table/optable,
/obj/effect/turf_decal/bot_red,
/turf/open/floor/iron/white/smooth_large,
/area/space)
"vd" = (
/obj/machinery/door/airlock/security/old/glass,
/turf/open/floor/mineral/plastitanium,
/area/space)
"ve" = (
/obj/effect/turf_decal/tile/yellow/opposingcorners,
/obj/structure/closet,
/turf/open/floor/iron/white,
/area/space)
"xq" = (
/obj/structure/window/reinforced/plasma/plastitanium,
/turf/open/floor/plating,
/area/space)
"xr" = (
/turf/open/floor/plating,
/area/space)
"yQ" = (
/turf/open/floor/iron,
/area/space)
"zG" = (
/obj/machinery/door/airlock/command/glass,
/turf/open/floor/iron/white,
/area/space)
"zQ" = (
/turf/closed/wall/mineral/plastitanium,
/area/space)
"Ar" = (
/obj/machinery/door/airlock/research/glass,
/turf/open/floor/iron/white/smooth_large,
/area/space)
"CC" = (
/obj/machinery/stasis,
/obj/effect/turf_decal/bot_red,
/turf/open/floor/iron/white/smooth_large,
/area/space)
"CW" = (
/obj/structure/closet,
/obj/effect/turf_decal/bot_red,
/obj/item/defibrillator/compact/loaded,
/turf/open/floor/iron/white/smooth_large,
/area/space)
"Gg" = (
/obj/machinery/door/airlock/command/glass,
/turf/open/floor/iron,
/area/space)
"Ir" = (
/obj/effect/turf_decal/tile/yellow/opposingcorners,
/obj/machinery/chem_master,
/turf/open/floor/iron/white,
/area/space)
"IA" = (
/obj/machinery/computer/operating,
/obj/effect/turf_decal/bot_red,
/turf/open/floor/iron/white/smooth_large,
/area/space)
"Ja" = (
/obj/effect/turf_decal/tile/yellow/opposingcorners,
/obj/machinery/chem_dispenser,
/turf/open/floor/iron/white,
/area/space)
"LJ" = (
/obj/structure/chair,
/turf/open/floor/mineral/plastitanium,
/area/space)
"LU" = (
/obj/machinery/computer/communications/syndicate{
	dir = 1
	},
/turf/open/floor/iron/dark,
/area/space)
"Ml" = (
/turf/open/floor/iron/white/smooth_large,
/area/space)
"Nt" = (
/obj/structure/bodycontainer/morgue,
/turf/open/floor/iron/dark,
/area/space)
"Pq" = (
/obj/machinery/door/airlock/command/glass,
/turf/open/floor/iron/dark,
/area/space)
"Qh" = (
/obj/structure/closet/crate/bin,
/turf/open/floor/iron/white/smooth_large,
/area/space)
"Qx" = (
/obj/structure/closet/crate/bin,
/turf/open/floor/iron/dark,
/area/space)
"QF" = (
/obj/structure/rack/shelf,
/obj/item/storage/medkit/tactical,
/obj/effect/turf_decal/bot_red,
/turf/open/floor/iron/white/smooth_large,
/area/space)
"QG" = (
/turf/open/space/basic,
/area/space)
"Rh" = (
/obj/structure/table,
/obj/effect/turf_decal/tile/holiday/rainbow/opposingcorners,
/obj/item/surgery_tray/full,
/turf/open/floor/iron/white,
/area/space)
"Ro" = (
/turf/open/floor/iron/dark,
/area/space)
"RP" = (
/turf/open/floor/mineral/plastitanium/red,
/area/space)
"Sa" = (
/obj/structure/closet,
/obj/item/clothing/glasses/hud/security/sunglasses/redsec,
/obj/item/clothing/glasses/hud/security/sunglasses/redsec,
/obj/item/clothing/glasses/hud/security/sunglasses/redsec,
/obj/item/clothing/head/helmet/sec/redsec,
/obj/item/clothing/head/helmet/sec/redsec,
/obj/item/clothing/head/helmet/sec/redsec,
/obj/item/clothing/suit/armor/vest/alt/sec/redsec,
/obj/item/clothing/suit/armor/vest/alt/sec/redsec,
/obj/item/clothing/suit/armor/vest/alt/sec/redsec,
/turf/open/floor/mineral/plastitanium/red,
/area/space)
"Sk" = (
/obj/structure/chair/office/light{
	dir = 4
	},
/turf/open/floor/mineral/plastitanium,
/area/space)
"Ug" = (
/obj/structure/table,
/obj/machinery/recharger,
/turf/open/floor/mineral/plastitanium,
/area/space)
"Uw" = (
/obj/structure/rack/shelf,
/turf/open/floor/mineral/plastitanium/red,
/area/space)
"Wq" = (
/obj/structure/chair{
	dir = 4;
	name = "Prosecution"
	},
/turf/open/floor/mineral/plastitanium,
/area/space)
"WB" = (
/obj/structure/table,
/obj/item/storage/medkit/coroner,
/turf/open/floor/iron/dark,
/area/space)
"Xa" = (
/obj/effect/turf_decal/tile/holiday/rainbow/opposingcorners,
/obj/structure/closet/crate/bin,
/turf/open/floor/iron/white,
/area/space)
"Ym" = (
/obj/machinery/computer/monitor{
	dir = 1
	},
/turf/open/floor/iron/dark,
/area/space)
"Yu" = (
/obj/structure/table,
/turf/open/floor/iron/dark,
/area/space)
"YY" = (
/obj/machinery/door/airlock/maintenance_hatch,
/turf/open/floor/iron/white,
/area/space)
"ZS" = (
/obj/structure/rack/shelf,
/obj/item/storage/medkit/advanced,
/obj/effect/turf_decal/bot_red,
/turf/open/floor/iron/white/smooth_large,
/area/space)

(1,1,1) = {"
QG
QG
QG
QG
QG
QG
QG
QG
QG
QG
QG
QG
QG
QG
QG
QG
QG
QG
QG
QG
QG
QG
QG
QG
QG
QG
QG
QG
QG
QG
QG
QG
QG
QG
QG
QG
QG
QG
QG
QG
QG
QG
QG
QG
QG
QG
QG
QG
QG
QG
QG
QG
QG
QG
QG
QG
QG
QG
QG
QG
QG
QG
QG
QG
"}
(2,1,1) = {"
QG
QG
QG
QG
QG
QG
QG
QG
QG
QG
QG
QG
QG
QG
QG
QG
QG
QG
QG
QG
QG
QG
QG
QG
QG
QG
QG
QG
QG
QG
QG
QG
QG
QG
QG
QG
QG
QG
QG
QG
QG
QG
QG
QG
QG
QG
QG
QG
QG
QG
QG
QG
QG
QG
QG
QG
QG
QG
QG
QG
QG
QG
QG
QG
"}
(3,1,1) = {"
QG
QG
QG
QG
QG
QG
QG
QG
QG
QG
QG
QG
QG
QG
QG
QG
QG
QG
QG
QG
QG
QG
QG
QG
QG
QG
QG
QG
QG
QG
QG
QG
QG
QG
QG
QG
QG
QG
QG
QG
QG
QG
QG
QG
QG
QG
QG
QG
QG
QG
QG
QG
QG
QG
QG
QG
QG
QG
QG
QG
QG
QG
QG
QG
"}
(4,1,1) = {"
QG
QG
QG
QG
QG
QG
QG
QG
QG
QG
QG
QG
QG
QG
QG
QG
QG
QG
QG
QG
QG
QG
QG
QG
QG
QG
QG
QG
QG
QG
QG
QG
QG
QG
QG
QG
QG
QG
QG
QG
QG
QG
QG
QG
QG
QG
QG
QG
QG
QG
QG
QG
QG
QG
QG
QG
QG
QG
QG
QG
QG
QG
QG
QG
"}
(5,1,1) = {"
QG
QG
QG
QG
QG
QG
QG
QG
QG
QG
QG
QG
QG
QG
QG
QG
QG
QG
QG
QG
QG
QG
QG
QG
QG
QG
QG
QG
QG
QG
QG
QG
QG
QG
QG
QG
QG
QG
QG
QG
QG
QG
QG
QG
QG
QG
QG
QG
QG
QG
QG
QG
QG
QG
QG
QG
QG
QG
QG
QG
QG
QG
QG
QG
"}
(6,1,1) = {"
QG
QG
QG
QG
QG
QG
QG
QG
QG
QG
QG
QG
QG
QG
QG
QG
QG
QG
QG
QG
QG
QG
QG
QG
QG
QG
QG
QG
QG
QG
QG
QG
QG
QG
QG
QG
QG
QG
QG
QG
QG
QG
QG
QG
QG
QG
QG
QG
QG
QG
QG
QG
QG
QG
QG
QG
QG
QG
QG
QG
QG
QG
QG
QG
"}
(7,1,1) = {"
QG
QG
QG
QG
QG
QG
QG
QG
QG
QG
QG
QG
QG
QG
QG
QG
QG
QG
QG
QG
QG
QG
QG
QG
QG
QG
QG
QG
QG
QG
QG
QG
QG
QG
QG
QG
QG
QG
QG
QG
QG
QG
QG
QG
QG
QG
QG
QG
QG
QG
QG
QG
QG
QG
QG
QG
QG
QG
QG
QG
QG
QG
QG
QG
"}
(8,1,1) = {"
QG
QG
QG
QG
QG
QG
QG
QG
QG
QG
QG
QG
QG
QG
QG
QG
QG
QG
QG
QG
QG
QG
QG
QG
QG
QG
QG
QG
QG
QG
QG
QG
QG
QG
QG
QG
QG
QG
QG
QG
QG
QG
QG
QG
QG
QG
QG
QG
QG
QG
QG
QG
QG
QG
QG
QG
QG
QG
QG
QG
QG
QG
QG
QG
"}
(9,1,1) = {"
QG
QG
QG
QG
QG
QG
QG
QG
QG
QG
QG
QG
QG
QG
QG
QG
QG
QG
QG
QG
QG
QG
QG
QG
QG
QG
QG
QG
QG
QG
QG
QG
QG
QG
QG
QG
QG
QG
QG
QG
QG
QG
QG
QG
QG
QG
QG
QG
QG
QG
QG
QG
QG
QG
QG
QG
QG
QG
QG
QG
QG
QG
QG
QG
"}
(10,1,1) = {"
QG
QG
QG
QG
QG
QG
QG
QG
QG
QG
QG
QG
QG
QG
QG
QG
QG
QG
QG
QG
QG
QG
QG
QG
QG
QG
QG
QG
QG
QG
QG
QG
QG
QG
QG
QG
QG
QG
QG
QG
QG
QG
QG
QG
QG
QG
QG
QG
QG
QG
QG
QG
QG
QG
QG
QG
QG
QG
QG
QG
QG
QG
QG
QG
"}
(11,1,1) = {"
QG
QG
QG
QG
QG
QG
QG
QG
QG
QG
QG
QG
QG
QG
QG
QG
QG
QG
QG
QG
QG
QG
QG
QG
QG
QG
QG
QG
QG
QG
QG
QG
QG
QG
QG
QG
QG
QG
QG
QG
QG
QG
QG
QG
QG
QG
QG
QG
QG
QG
QG
QG
QG
QG
QG
QG
QG
QG
QG
QG
QG
QG
QG
QG
"}
(12,1,1) = {"
QG
QG
QG
QG
QG
QG
QG
QG
QG
QG
QG
QG
QG
QG
QG
QG
QG
QG
QG
QG
QG
QG
QG
QG
QG
QG
QG
QG
QG
QG
QG
QG
QG
QG
QG
QG
QG
QG
QG
QG
QG
QG
QG
QG
QG
QG
QG
QG
QG
QG
QG
QG
QG
QG
QG
QG
QG
QG
QG
QG
QG
QG
QG
QG
"}
(13,1,1) = {"
QG
QG
QG
QG
QG
QG
QG
QG
QG
QG
QG
QG
QG
QG
QG
QG
QG
QG
QG
QG
QG
QG
QG
QG
QG
QG
QG
QG
QG
QG
QG
QG
QG
QG
QG
QG
QG
QG
QG
QG
QG
QG
QG
QG
QG
QG
QG
QG
QG
QG
QG
QG
QG
QG
QG
QG
QG
QG
QG
QG
QG
QG
QG
QG
"}
(14,1,1) = {"
QG
QG
QG
QG
QG
QG
QG
QG
QG
QG
QG
QG
QG
QG
QG
QG
QG
QG
QG
QG
QG
QG
QG
QG
QG
QG
QG
QG
QG
QG
QG
QG
QG
QG
QG
QG
QG
QG
QG
QG
QG
QG
QG
QG
QG
QG
QG
QG
QG
QG
QG
QG
QG
QG
QG
QG
QG
QG
QG
QG
QG
QG
QG
QG
"}
(15,1,1) = {"
QG
QG
QG
QG
QG
QG
QG
QG
QG
QG
QG
QG
QG
QG
QG
QG
QG
QG
QG
QG
QG
QG
QG
QG
QG
QG
QG
QG
QG
QG
QG
QG
QG
QG
QG
QG
QG
QG
QG
QG
QG
QG
QG
QG
QG
QG
QG
QG
QG
QG
QG
QG
QG
QG
QG
QG
QG
QG
QG
QG
QG
QG
QG
QG
"}
(16,1,1) = {"
QG
QG
QG
QG
QG
QG
QG
QG
QG
QG
QG
QG
QG
QG
QG
QG
QG
QG
QG
QG
QG
QG
QG
QG
QG
QG
QG
QG
QG
QG
QG
QG
QG
QG
QG
QG
QG
QG
QG
QG
QG
QG
QG
QG
QG
QG
QG
QG
QG
QG
QG
QG
QG
QG
QG
QG
QG
QG
QG
QG
QG
QG
QG
QG
"}
(17,1,1) = {"
QG
QG
QG
QG
QG
QG
QG
QG
QG
QG
QG
QG
QG
QG
QG
QG
QG
QG
QG
QG
QG
QG
QG
QG
QG
QG
QG
QG
QG
QG
QG
QG
QG
QG
QG
QG
QG
QG
QG
QG
QG
QG
QG
QG
QG
QG
QG
QG
QG
QG
QG
QG
QG
QG
QG
QG
QG
QG
QG
QG
QG
QG
QG
QG
"}
(18,1,1) = {"
QG
QG
QG
QG
QG
QG
QG
QG
QG
QG
QG
QG
QG
QG
QG
QG
QG
QG
QG
QG
zQ
QG
QG
QG
QG
QG
QG
QG
QG
QG
QG
QG
QG
QG
QG
QG
QG
QG
QG
QG
QG
QG
QG
QG
QG
QG
QG
QG
QG
QG
QG
QG
QG
QG
QG
QG
QG
QG
QG
QG
QG
QG
QG
QG
"}
(19,1,1) = {"
QG
QG
QG
QG
QG
QG
QG
QG
QG
QG
QG
QG
QG
QG
QG
QG
QG
QG
QG
QG
zQ
zQ
zQ
zQ
zQ
zQ
zQ
zQ
zQ
zQ
zQ
zQ
zQ
QG
QG
QG
QG
QG
QG
QG
QG
QG
QG
QG
QG
QG
QG
QG
QG
QG
QG
QG
QG
QG
QG
QG
QG
QG
QG
QG
QG
QG
QG
QG
"}
(20,1,1) = {"
QG
QG
QG
QG
QG
QG
QG
QG
QG
QG
QG
QG
QG
QG
QG
QG
QG
QG
QG
QG
zQ
va
uj
uj
zQ
QG
QG
QG
QG
zQ
QG
QG
zQ
QG
QG
QG
QG
QG
QG
QG
QG
QG
QG
QG
QG
QG
QG
QG
QG
QG
QG
QG
QG
QG
QG
QG
QG
QG
QG
QG
QG
QG
QG
QG
"}
(21,1,1) = {"
QG
QG
QG
QG
QG
QG
QG
QG
QG
QG
QG
QG
QG
QG
QG
QG
QG
QG
QG
QG
zQ
IA
Rh
uj
zQ
QG
QG
QG
QG
zQ
QG
QG
zQ
QG
QG
QG
QG
QG
QG
QG
QG
QG
QG
QG
QG
QG
QG
QG
QG
QG
QG
QG
QG
QG
QG
QG
QG
QG
QG
QG
QG
QG
QG
QG
"}
(22,1,1) = {"
QG
QG
QG
QG
QG
QG
QG
QG
QG
QG
QG
QG
QG
QG
QG
QG
QG
QG
QG
QG
zQ
uj
uj
uj
zQ
QG
QG
QG
QG
zQ
QG
QG
zQ
QG
QG
QG
QG
QG
QG
QG
QG
QG
QG
QG
QG
QG
QG
QG
QG
QG
QG
QG
QG
QG
QG
QG
QG
QG
QG
QG
QG
QG
QG
QG
"}
(23,1,1) = {"
QG
QG
QG
QG
QG
QG
QG
QG
QG
QG
QG
QG
QG
QG
QG
QG
QG
QG
QG
QG
zQ
fh
uj
Xa
zQ
QG
QG
QG
QG
zQ
QG
QG
zQ
QG
QG
QG
xq
bN
yQ
yQ
QG
QG
QG
QG
QG
QG
QG
QG
QG
QG
QG
QG
QG
QG
QG
QG
QG
QG
QG
QG
QG
QG
QG
QG
"}
(24,1,1) = {"
QG
QG
QG
QG
QG
QG
QG
QG
QG
QG
QG
QG
QG
QG
QG
QG
QG
QG
QG
QG
zQ
xq
mD
xq
zQ
xq
Ml
xq
zQ
zQ
zQ
zQ
zQ
zQ
zQ
xq
xq
bN
yQ
yQ
zQ
QG
QG
QG
QG
QG
QG
QG
QG
QG
QG
QG
QG
QG
QG
QG
QG
QG
QG
QG
QG
QG
QG
QG
"}
(25,1,1) = {"
QG
QG
QG
QG
QG
QG
QG
QG
QG
QG
QG
QG
QG
QG
QG
QG
QG
QG
QG
QG
zQ
uj
uj
uj
uj
uj
uj
uj
uj
uj
uj
uj
Gg
yQ
yQ
Gg
yQ
bN
yQ
yQ
zQ
QG
QG
QG
zQ
zQ
zQ
zQ
QG
QG
QG
QG
QG
QG
QG
QG
QG
QG
QG
QG
QG
QG
QG
QG
"}
(26,1,1) = {"
QG
QG
QG
QG
QG
QG
QG
QG
QG
QG
QG
QG
QG
QG
QG
QG
QG
QG
QG
QG
zQ
uj
uj
uj
uj
uj
uj
uj
uj
uj
uj
uj
xq
yQ
yQ
xq
yQ
bN
yQ
yQ
zQ
QG
QG
QG
zQ
uX
dS
zQ
QG
QG
QG
QG
QG
QG
QG
QG
QG
QG
QG
QG
QG
QG
QG
QG
"}
(27,1,1) = {"
QG
QG
QG
QG
QG
QG
QG
QG
QG
QG
QG
QG
QG
QG
QG
QG
QG
QG
QG
QG
zQ
uj
uj
uj
uj
uj
uj
uj
uj
uj
uj
uj
Gg
yQ
yQ
Gg
yQ
bN
yQ
yQ
zQ
QG
QG
QG
zQ
dS
dS
zQ
zQ
zQ
zQ
zQ
QG
QG
QG
QG
QG
QG
QG
QG
QG
QG
QG
QG
"}
(28,1,1) = {"
QG
QG
QG
QG
QG
QG
QG
QG
QG
QG
QG
QG
QG
QG
QG
QG
zQ
zQ
zQ
zQ
zQ
zQ
zQ
zQ
uj
uj
uj
xq
xq
ab
zQ
zQ
zQ
zQ
zQ
xq
xq
bN
yQ
yQ
zQ
QG
QG
QG
zQ
dS
dS
dS
dS
dS
dS
zQ
QG
QG
QG
QG
QG
QG
QG
QG
QG
QG
QG
QG
"}
(29,1,1) = {"
QG
QG
QG
QG
QG
QG
QG
QG
QG
QG
QG
QG
QG
QG
QG
QG
zQ
rj
rj
rj
rj
rj
rj
xq
uj
uj
uj
xq
Ja
nh
up
ve
zQ
QG
QG
QG
xq
bN
yQ
yQ
zQ
zQ
zQ
zQ
zQ
dS
dS
dS
dS
dS
dS
zQ
QG
QG
QG
QG
QG
QG
QG
QG
QG
QG
QG
QG
"}
(30,1,1) = {"
QG
QG
QG
QG
QG
QG
QG
QG
QG
QG
QG
QG
QG
QG
QG
QG
zQ
rj
rj
rj
rj
rj
rj
xq
uj
uj
uj
zQ
Ir
nh
aQ
nh
zQ
QG
QG
QG
zQ
bN
yQ
yQ
zQ
ne
Wq
Wq
xq
dS
dS
zQ
zQ
jI
zQ
zQ
QG
QG
QG
QG
QG
QG
QG
QG
QG
QG
QG
QG
"}
(31,1,1) = {"
QG
QG
QG
QG
QG
QG
QG
QG
QG
QG
QG
QG
QG
QG
QG
QG
zQ
CC
kr
CC
rj
rj
rj
xq
uj
uj
uj
Ar
nh
nh
nh
nh
zQ
QG
QG
QG
zQ
bN
yQ
yQ
zQ
LJ
dS
dS
vd
dS
dS
zQ
dQ
RP
Uw
zQ
QG
QG
QG
QG
QG
QG
QG
QG
QG
QG
QG
QG
"}
(32,1,1) = {"
QG
QG
QG
QG
QG
QG
QG
QG
QG
QG
QG
QG
QG
zQ
bd
zQ
zQ
xq
xq
zQ
rj
rj
rj
zQ
uj
uj
uj
zQ
zQ
zQ
zQ
zQ
zQ
QG
QG
QG
zQ
bN
yQ
oD
zQ
dS
dS
dS
xq
dS
dS
zQ
lZ
RP
Sa
zQ
QG
QG
QG
QG
QG
QG
QG
QG
QG
QG
QG
QG
"}
(33,1,1) = {"
QG
QG
QG
QG
QG
QG
QG
QG
QG
QG
QG
QG
QG
zQ
xr
xr
zQ
ZS
oq
xq
rj
rj
rj
xq
uj
uj
uj
zQ
ly
WB
Nt
Nt
zQ
zQ
zQ
zQ
zQ
bN
yQ
zQ
zQ
zQ
zQ
zQ
zQ
dS
dS
zQ
zQ
zQ
zQ
zQ
QG
QG
QG
QG
QG
QG
QG
QG
QG
QG
QG
QG
"}
(34,1,1) = {"
QG
QG
QG
QG
QG
QG
QG
QG
QG
QG
QG
QG
QG
zQ
xr
xr
YY
rj
rj
zG
rj
rj
rj
zG
uj
uj
uj
zQ
Ro
Ro
Ro
Ro
zQ
QG
zQ
yQ
yQ
bN
yQ
xq
dS
dS
dS
dS
jI
dS
dS
zQ
QG
QG
QG
QG
QG
QG
QG
QG
QG
QG
QG
QG
QG
QG
QG
QG
"}
(35,1,1) = {"
QG
QG
QG
QG
QG
QG
QG
QG
QG
QG
QG
QG
QG
zQ
xr
xr
zQ
CW
QF
xq
Ml
Ml
Qh
xq
uj
uj
uj
fz
Ro
Ro
Ro
Ro
zQ
QG
zQ
yQ
yQ
bN
yQ
zQ
dS
Ug
Sk
dS
zQ
xq
vd
zQ
QG
QG
QG
QG
QG
QG
QG
QG
QG
QG
QG
QG
QG
QG
QG
QG
"}
(36,1,1) = {"
QG
QG
QG
QG
QG
QG
QG
QG
QG
QG
QG
xq
xq
zQ
zQ
xr
zQ
zQ
zQ
zQ
zQ
zQ
zQ
zQ
uj
uj
uj
zQ
zQ
zQ
zQ
zQ
zQ
zQ
zQ
Pq
zQ
bN
yQ
xq
dS
ne
gI
dS
zQ
yQ
yQ
zQ
QG
QG
QG
QG
QG
QG
QG
QG
QG
QG
QG
QG
QG
QG
QG
QG
"}
(37,1,1) = {"
QG
QG
QG
QG
QG
QG
QG
QG
QG
QG
QG
xq
xr
xr
zQ
xr
xr
xr
xr
xr
xr
xr
xr
zQ
zQ
YY
zQ
zQ
xr
xr
zQ
Yu
Yu
Yu
Qx
Ro
zQ
bN
yQ
xq
xq
xq
zQ
xq
zQ
yQ
yQ
zQ
zQ
zQ
zQ
zQ
zQ
zQ
QG
QG
QG
QG
QG
QG
QG
QG
QG
QG
"}
(38,1,1) = {"
QG
QG
QG
QG
QG
QG
QG
QG
QG
QG
QG
zQ
xr
xr
zQ
xr
xr
xr
xr
xr
xr
xr
xr
xr
xr
xr
xr
xr
xr
xr
zQ
Ro
pP
Yu
Ro
Ro
zQ
bN
yQ
yQ
yQ
yQ
yQ
yQ
yQ
yQ
yQ
yQ
yQ
yQ
yQ
yQ
yQ
zQ
QG
QG
QG
QG
QG
QG
QG
QG
QG
QG
"}
(39,1,1) = {"
QG
QG
QG
QG
QG
QG
QG
QG
QG
QG
QG
xq
xr
xr
zQ
zQ
zQ
zQ
zQ
zQ
zQ
xr
xr
xr
xr
xr
xr
xr
xr
xr
zQ
Ro
Ro
Ro
Ro
Ro
zQ
bN
yQ
yQ
yQ
yQ
yQ
yQ
yQ
yQ
yQ
yQ
yQ
yQ
yQ
yQ
yQ
zQ
QG
QG
QG
QG
QG
QG
QG
QG
QG
QG
"}
(40,1,1) = {"
QG
QG
QG
QG
QG
QG
QG
QG
QG
QG
QG
xq
xq
zQ
zQ
QG
QG
QG
QG
QG
zQ
zQ
zQ
zQ
zQ
zQ
zQ
zQ
xr
xr
zQ
Ro
Ro
Ro
Ro
Ro
zQ
bN
yQ
zQ
zQ
zQ
zQ
zQ
zQ
zQ
zQ
zQ
zQ
zQ
zQ
zQ
zQ
zQ
QG
QG
QG
QG
QG
QG
QG
QG
QG
QG
"}
(41,1,1) = {"
QG
QG
QG
QG
QG
QG
QG
QG
QG
QG
QG
QG
QG
QG
QG
QG
QG
QG
QG
QG
QG
QG
QG
QG
QG
QG
QG
zQ
xr
xr
zQ
Ro
Ro
Ro
sH
ss
zQ
bN
yQ
zQ
QG
QG
QG
QG
QG
QG
QG
QG
QG
QG
QG
QG
QG
QG
QG
QG
QG
QG
QG
QG
QG
QG
QG
QG
"}
(42,1,1) = {"
QG
QG
QG
QG
QG
QG
QG
QG
QG
QG
QG
QG
QG
QG
QG
QG
QG
QG
QG
QG
QG
QG
QG
QG
QG
QG
QG
zQ
xr
xr
zQ
Ro
sH
Ym
Ro
LU
zQ
bN
yQ
zQ
QG
QG
QG
QG
QG
QG
QG
QG
QG
QG
QG
QG
QG
QG
QG
QG
QG
QG
QG
QG
QG
QG
QG
QG
"}
(43,1,1) = {"
QG
QG
QG
QG
QG
QG
QG
QG
QG
QG
QG
QG
QG
QG
QG
QG
QG
QG
QG
QG
QG
QG
QG
zQ
zQ
zQ
zQ
zQ
zQ
zQ
zQ
xq
xq
xq
xq
xq
zQ
bN
yQ
zQ
QG
QG
QG
QG
QG
QG
QG
QG
QG
QG
QG
QG
QG
QG
QG
QG
QG
QG
QG
QG
QG
QG
QG
QG
"}
(44,1,1) = {"
QG
QG
QG
QG
QG
QG
QG
QG
QG
QG
QG
QG
QG
QG
QG
QG
QG
QG
QG
QG
QG
QG
QG
QG
QG
bN
bN
bN
bN
bN
bN
bN
bN
bN
bN
bN
bN
bN
yQ
zQ
QG
QG
QG
QG
QG
QG
QG
QG
QG
QG
QG
QG
QG
QG
QG
QG
QG
QG
QG
QG
QG
QG
QG
QG
"}
(45,1,1) = {"
QG
QG
QG
QG
QG
QG
QG
QG
QG
QG
QG
QG
QG
QG
QG
QG
QG
QG
QG
QG
QG
QG
QG
QG
QG
yQ
yQ
yQ
yQ
yQ
yQ
yQ
yQ
yQ
yQ
yQ
yQ
yQ
yQ
zQ
QG
QG
QG
QG
QG
QG
QG
QG
QG
QG
QG
QG
QG
QG
QG
QG
QG
QG
QG
QG
QG
QG
QG
QG
"}
(46,1,1) = {"
QG
QG
QG
QG
QG
QG
QG
QG
QG
QG
QG
QG
QG
QG
QG
QG
QG
QG
QG
QG
QG
QG
QG
zQ
zQ
zQ
zQ
xq
xq
zQ
xq
xq
zQ
xq
xq
zQ
zQ
yQ
yQ
zQ
QG
QG
QG
QG
QG
QG
QG
QG
QG
QG
QG
QG
QG
QG
QG
QG
QG
QG
QG
QG
QG
QG
QG
QG
"}
(47,1,1) = {"
QG
QG
QG
QG
QG
QG
QG
QG
QG
QG
QG
QG
QG
QG
QG
QG
QG
QG
QG
QG
QG
QG
QG
QG
QG
QG
QG
QG
QG
QG
QG
QG
QG
QG
QG
QG
zQ
yQ
yQ
zQ
QG
QG
QG
QG
QG
QG
QG
QG
QG
QG
QG
QG
QG
QG
QG
QG
QG
QG
QG
QG
QG
QG
QG
QG
"}
(48,1,1) = {"
QG
QG
QG
QG
QG
QG
QG
QG
QG
QG
QG
QG
QG
QG
QG
QG
QG
QG
QG
QG
QG
QG
QG
QG
QG
QG
QG
QG
QG
QG
QG
QG
QG
QG
QG
QG
zQ
xq
xq
zQ
QG
QG
QG
QG
QG
QG
QG
QG
QG
QG
QG
QG
QG
QG
QG
QG
QG
QG
QG
QG
QG
QG
QG
QG
"}
(49,1,1) = {"
QG
QG
QG
QG
QG
QG
QG
QG
QG
QG
QG
QG
QG
QG
QG
QG
QG
QG
QG
QG
QG
QG
QG
QG
QG
QG
QG
QG
QG
QG
QG
QG
QG
QG
QG
QG
QG
QG
QG
QG
QG
QG
QG
QG
QG
QG
QG
QG
QG
QG
QG
QG
QG
QG
QG
QG
QG
QG
QG
QG
QG
QG
QG
QG
"}
(50,1,1) = {"
QG
QG
QG
QG
QG
QG
QG
QG
QG
QG
QG
QG
QG
QG
QG
QG
QG
QG
QG
QG
QG
QG
QG
QG
QG
QG
QG
QG
QG
QG
QG
QG
QG
QG
QG
QG
QG
QG
QG
QG
QG
QG
QG
QG
QG
QG
QG
QG
QG
QG
QG
QG
QG
QG
QG
QG
QG
QG
QG
QG
QG
QG
QG
QG
"}
(51,1,1) = {"
QG
QG
QG
QG
QG
QG
QG
QG
QG
QG
QG
QG
QG
QG
QG
QG
QG
QG
QG
QG
QG
QG
QG
QG
QG
QG
QG
QG
QG
QG
QG
QG
QG
QG
QG
QG
QG
QG
QG
QG
QG
QG
QG
QG
QG
QG
QG
QG
QG
QG
QG
QG
QG
QG
QG
QG
QG
QG
QG
QG
QG
QG
QG
QG
"}
(52,1,1) = {"
QG
QG
QG
QG
QG
QG
QG
QG
QG
QG
QG
QG
QG
QG
QG
QG
QG
QG
QG
QG
QG
QG
QG
QG
QG
QG
QG
QG
QG
QG
QG
QG
QG
QG
QG
QG
QG
QG
QG
QG
QG
QG
QG
QG
QG
QG
QG
QG
QG
QG
QG
QG
QG
QG
QG
QG
QG
QG
QG
QG
QG
QG
QG
QG
"}
(53,1,1) = {"
QG
QG
QG
QG
QG
QG
QG
QG
QG
QG
QG
QG
QG
QG
QG
QG
QG
QG
QG
QG
QG
QG
QG
QG
QG
QG
QG
QG
QG
QG
QG
QG
QG
QG
QG
QG
QG
QG
QG
QG
QG
QG
QG
QG
QG
QG
QG
QG
QG
QG
QG
QG
QG
QG
QG
QG
QG
QG
QG
QG
QG
QG
QG
QG
"}
(54,1,1) = {"
QG
QG
QG
QG
QG
QG
QG
QG
QG
QG
QG
QG
QG
QG
QG
QG
QG
QG
QG
QG
QG
QG
QG
QG
QG
QG
QG
QG
QG
QG
QG
QG
QG
QG
QG
QG
QG
QG
QG
QG
QG
QG
QG
QG
QG
QG
QG
QG
QG
QG
QG
QG
QG
QG
QG
QG
QG
QG
QG
QG
QG
QG
QG
QG
"}
(55,1,1) = {"
QG
QG
QG
QG
QG
QG
QG
QG
QG
QG
QG
QG
QG
QG
QG
QG
QG
QG
QG
QG
QG
QG
QG
QG
QG
QG
QG
QG
QG
QG
QG
QG
QG
QG
QG
QG
QG
QG
QG
QG
QG
QG
QG
QG
QG
QG
QG
QG
QG
QG
QG
QG
QG
QG
QG
QG
QG
QG
QG
QG
QG
QG
QG
QG
"}
(56,1,1) = {"
QG
QG
QG
QG
QG
QG
QG
QG
QG
QG
QG
QG
QG
QG
QG
QG
QG
QG
QG
QG
QG
QG
QG
QG
QG
QG
QG
QG
QG
QG
QG
QG
QG
QG
QG
QG
QG
QG
QG
QG
QG
QG
QG
QG
QG
QG
QG
QG
QG
QG
QG
QG
QG
QG
QG
QG
QG
QG
QG
QG
QG
QG
QG
QG
"}
(57,1,1) = {"
QG
QG
QG
QG
QG
QG
QG
QG
QG
QG
QG
QG
QG
QG
QG
QG
QG
QG
QG
QG
QG
QG
QG
QG
QG
QG
QG
QG
QG
QG
QG
QG
QG
QG
QG
QG
QG
QG
QG
QG
QG
QG
QG
QG
QG
QG
QG
QG
QG
QG
QG
QG
QG
QG
QG
QG
QG
QG
QG
QG
QG
QG
QG
QG
"}
(58,1,1) = {"
QG
QG
QG
QG
QG
QG
QG
QG
QG
QG
QG
QG
QG
QG
QG
QG
QG
QG
QG
QG
QG
QG
QG
QG
QG
QG
QG
QG
QG
QG
QG
QG
QG
QG
QG
QG
QG
QG
QG
QG
QG
QG
QG
QG
QG
QG
QG
QG
QG
QG
QG
QG
QG
QG
QG
QG
QG
QG
QG
QG
QG
QG
QG
QG
"}
(59,1,1) = {"
QG
QG
QG
QG
QG
QG
QG
QG
QG
QG
QG
QG
QG
QG
QG
QG
QG
QG
QG
QG
QG
QG
QG
QG
QG
QG
QG
QG
QG
QG
QG
QG
QG
QG
QG
QG
QG
QG
QG
QG
QG
QG
QG
QG
QG
QG
QG
QG
QG
QG
QG
QG
QG
QG
QG
QG
QG
QG
QG
QG
QG
QG
QG
QG
"}
(60,1,1) = {"
QG
QG
QG
QG
QG
QG
QG
QG
QG
QG
QG
QG
QG
QG
QG
QG
QG
QG
QG
QG
QG
QG
QG
QG
QG
QG
QG
QG
QG
QG
QG
QG
QG
QG
QG
QG
QG
QG
QG
QG
QG
QG
QG
QG
QG
QG
QG
QG
QG
QG
QG
QG
QG
QG
QG
QG
QG
QG
QG
QG
QG
QG
QG
QG
"}
(61,1,1) = {"
QG
QG
QG
QG
QG
QG
QG
QG
QG
QG
QG
QG
QG
QG
QG
QG
QG
QG
QG
QG
QG
QG
QG
QG
QG
QG
QG
QG
QG
QG
QG
QG
QG
QG
QG
QG
QG
QG
QG
QG
QG
QG
QG
QG
QG
QG
QG
QG
QG
QG
QG
QG
QG
QG
QG
QG
QG
QG
QG
QG
QG
QG
QG
QG
"}
(62,1,1) = {"
QG
QG
QG
QG
QG
QG
QG
QG
QG
QG
QG
QG
QG
QG
QG
QG
QG
QG
QG
QG
QG
QG
QG
QG
QG
QG
QG
QG
QG
QG
QG
QG
QG
QG
QG
QG
QG
QG
QG
QG
QG
QG
QG
QG
QG
QG
QG
QG
QG
QG
QG
QG
QG
QG
QG
QG
QG
QG
QG
QG
QG
QG
QG
QG
"}
(63,1,1) = {"
QG
QG
QG
QG
QG
QG
QG
QG
QG
QG
QG
QG
QG
QG
QG
QG
QG
QG
QG
QG
QG
QG
QG
QG
QG
QG
QG
QG
QG
QG
QG
QG
QG
QG
QG
QG
QG
QG
QG
QG
QG
QG
QG
QG
QG
QG
QG
QG
QG
QG
QG
QG
QG
QG
QG
QG
QG
QG
QG
QG
QG
QG
QG
QG
"}
(64,1,1) = {"
QG
QG
QG
QG
QG
QG
QG
QG
QG
QG
QG
QG
QG
QG
QG
QG
QG
QG
QG
QG
QG
QG
QG
QG
QG
QG
QG
QG
QG
QG
QG
QG
QG
QG
QG
QG
QG
QG
QG
QG
QG
QG
QG
QG
QG
QG
QG
QG
QG
QG
QG
QG
QG
QG
QG
QG
QG
QG
QG
QG
QG
QG
QG
QG
"}
