//MAP CONVERTED BY dmm2tgm.py THIS HEADER COMMENT PREVENTS RECONVERSION, DO NOT REMOVE
"b" = (
/obj/machinery/computer/shuttle/arrivals,
/obj/machinery/light/directional/north,
/turf/open/floor/iron/shuttle/arrivals,
/area/shuttle/arrival)
"c" = (
/obj/structure/chair/sofa/bench/right{
	dir = 1
	},
/turf/open/floor/iron/shuttle/arrivals,
/area/shuttle/arrival)
"m" = (
/obj/structure/chair/sofa/bench/right,
/turf/open/floor/iron/shuttle/arrivals,
/area/shuttle/arrival)
"n" = (
/turf/open/floor/iron/shuttle/arrivals{
	icon_state = "sign_1"
	},
/area/shuttle/arrival)
"o" = (
/obj/docking_port/mobile/arrivals_skyrat,
/turf/closed/wall/mineral/titanium,
/area/shuttle/arrival)
"s" = (
/obj/machinery/door/airlock/silver/glass{
	dir = 4
	},
/obj/machinery/status_display/shuttle/directional/south{
	shuttle_id = "arrivals_shuttle"
	},
/turf/open/floor/iron/shuttle/arrivals,
/area/shuttle/arrival)
"v" = (
/obj/machinery/light/directional/west,
/turf/open/floor/iron/shuttle/arrivals{
	icon_state = "sign_2"
	},
/area/shuttle/arrival)
"w" = (
/turf/closed/wall/mineral/titanium,
/area/shuttle/arrival)
"x" = (
/turf/open/floor/iron/shuttle/arrivals,
/area/shuttle/arrival)
"J" = (
/obj/structure/window/reinforced/shuttle,
/turf/open/floor/plating,
/area/shuttle/arrival)
"M" = (
/obj/structure/closet/crate/bin,
/turf/open/floor/iron/shuttle/arrivals{
	icon_state = "sign_1"
	},
/area/shuttle/arrival)
"N" = (
/obj/machinery/light/directional/south,
/turf/open/floor/iron/shuttle/arrivals{
	icon_state = "sign_3"
	},
/area/shuttle/arrival)
"O" = (
/obj/structure/chair/sofa/bench/left{
	dir = 1
	},
/turf/open/floor/iron/shuttle/arrivals,
/area/shuttle/arrival)
"S" = (
/obj/structure/chair/sofa/bench/left,
/turf/open/floor/iron/shuttle/arrivals,
/area/shuttle/arrival)
"U" = (
/obj/machinery/door/airlock/external,
/turf/open/floor/iron/shuttle/arrivals,
/area/shuttle/arrival)
"V" = (
/obj/structure/closet/emcloset/anchored,
/turf/open/floor/iron/shuttle/arrivals,
/area/shuttle/arrival)
"X" = (
/obj/machinery/light/directional/east,
/turf/open/floor/iron/shuttle/arrivals{
	icon_state = "sign_2"
	},
/area/shuttle/arrival)

(1,1,1) = {"
w
w
w
w
w
"}
(2,1,1) = {"
w
w
M
n
w
"}
(3,1,1) = {"
w
V
x
X
U
"}
(4,1,1) = {"
w
w
s
w
w
"}
(5,1,1) = {"
J
m
x
O
J
"}
(6,1,1) = {"
J
S
x
c
J
"}
(7,1,1) = {"
w
b
x
N
w
"}
(8,1,1) = {"
J
m
x
O
J
"}
(9,1,1) = {"
J
S
x
c
J
"}
(10,1,1) = {"
w
w
s
w
w
"}
(11,1,1) = {"
w
V
x
v
U
"}
(12,1,1) = {"
w
w
n
n
w
"}
(13,1,1) = {"
w
w
w
o
w
"}
