//MAP CONVERTED BY dmm2tgm.py THIS HEADER COMMENT PREVENTS RECONVERSION, DO NOT REMOVE
"ak" = (
/obj/machinery/suit_storage_unit/security,
/turf/open/floor/iron/dark/smooth_large,
/area/station)
"bn" = (
/obj/structure/window/reinforced/spawner/directional/east,
/obj/machinery/airalarm/directional/north,
/turf/open/floor/wood,
/area/station)
"bJ" = (
/obj/structure/disposalpipe/segment{
	dir = 4
	},
/turf/open/floor/plating,
/area/station)
"ca" = (
/obj/effect/turf_decal/tile/dark/opposingcorners,
/obj/effect/landmark/observer_start,
/turf/open/floor/iron/dark,
/area/station)
"ci" = (
/obj/structure/ladder,
/turf/open/floor/plating,
/area/station)
"cL" = (
/obj/structure/grille,
/turf/open/floor/plating,
/area/station)
"da" = (
/obj/effect/turf_decal/tile/dark/opposingcorners,
/obj/machinery/light/dim/directional/west,
/turf/open/floor/iron/dark,
/area/station)
"eg" = (
/obj/effect/turf_decal/tile/neutral/fourcorners,
/turf/open/floor/iron/dark,
/area/station)
"ej" = (
/obj/effect/spawner/structure/window/reinforced,
/obj/machinery/door/poddoor/shutters/preopen{
	id = "lawyerprivacy";
	name = "Lawyer's Privacy Shutter"
	},
/turf/open/floor/plating,
/area/station)
"fj" = (
/obj/structure/railing,
/turf/open/floor/plating,
/area/station)
"gH" = (
/obj/machinery/door/airlock/maintenance,
/obj/machinery/atmospherics/pipe/smart/simple/scrubbers/hidden/layer2{
	dir = 4
	},
/obj/machinery/atmospherics/pipe/smart/simple/supply/hidden/layer4{
	dir = 4
	},
/obj/structure/cable,
/turf/open/floor/plating,
/area/station)
"hp" = (
/turf/closed/wall,
/area/space)
"hs" = (
/obj/machinery/door/airlock{
	name = "Law Office"
	},
/turf/open/floor/iron/dark,
/area/station)
"ir" = (
/obj/machinery/button/door{
	id = "lawyerprivacy";
	name = "Lawyer's Privacy Control";
	pixel_x = 24
	},
/turf/open/floor/wood,
/area/station)
"iT" = (
/obj/machinery/light_switch/directional/west,
/turf/open/floor/wood,
/area/station)
"iU" = (
/obj/machinery/atmospherics/pipe/smart/simple/scrubbers/hidden/layer2{
	dir = 4
	},
/obj/machinery/atmospherics/pipe/smart/simple/supply/hidden/layer4{
	dir = 4
	},
/obj/structure/cable,
/turf/open/floor/plating,
/area/station)
"jc" = (
/obj/effect/landmark/start/lawyer,
/turf/open/floor/wood,
/area/station)
"jq" = (
/turf/open/floor/iron/dark/smooth_large,
/area/station)
"jt" = (
/obj/structure/lattice/catwalk,
/obj/structure/disposalpipe/segment,
/turf/open/openspace,
/area/station)
"kx" = (
/obj/structure/grille,
/obj/structure/window/reinforced/spawner/directional/east,
/turf/open/floor/plating,
/area/station)
"lm" = (
/turf/open/openspace,
/area/station)
"lp" = (
/obj/machinery/door/airlock/maintenance,
/obj/structure/disposalpipe/segment{
	dir = 4
	},
/turf/open/floor/plating,
/area/station)
"md" = (
/obj/structure/table/wood,
/obj/structure/filingcabinet/employment{
	pixel_y = 12;
	pixel_x = -6
	},
/obj/item/kirbyplants{
	icon_state = "plant-17";
	pixel_y = 20;
	pixel_x = 7
	},
/obj/item/paper_bin{
	pixel_y = -4;
	pixel_x = 6
	},
/obj/item/pen{
	pixel_x = 7;
	pixel_y = -3
	},
/turf/open/floor/wood,
/area/station)
"mw" = (
/obj/effect/turf_decal/tile/dark/opposingcorners,
/obj/structure/rack,
/obj/item/clothing/suit/trenchbrown,
/obj/item/clothing/suit/trenchbrown,
/turf/open/floor/iron/dark,
/area/station)
"mN" = (
/obj/structure/lattice,
/turf/open/openspace,
/area/station)
"mQ" = (
/obj/machinery/door/firedoor,
/turf/open/floor/iron/dark,
/area/station)
"mY" = (
/obj/structure/closet/emcloset,
/turf/open/floor/plating,
/area/station)
"ns" = (
/obj/machinery/light/floor,
/turf/open/floor/plating,
/area/station)
"nG" = (
/obj/structure/railing,
/obj/structure/disposalpipe/segment,
/turf/open/floor/plating,
/area/station)
"ou" = (
/obj/machinery/photocopier,
/obj/effect/turf_decal/tile/dark/opposingcorners,
/obj/effect/turf_decal/bot_white,
/turf/open/floor/iron/dark,
/area/station)
"pw" = (
/turf/open/floor/iron/dark/small,
/area/station)
"pW" = (
/obj/structure/railing{
	dir = 4
	},
/obj/item/kirbyplants/random,
/obj/effect/turf_decal/tile/neutral/fourcorners,
/turf/open/floor/iron/dark,
/area/station)
"qz" = (
/obj/structure/rack,
/obj/structure/noticeboard/directional/north,
/obj/effect/turf_decal/tile/dark/opposingcorners,
/obj/item/folder/red,
/obj/item/folder/red,
/obj/item/folder/blue,
/obj/item/folder/blue,
/obj/item/clothing/glasses/sunglasses/big,
/turf/open/floor/iron/dark,
/area/station)
"rE" = (
/obj/structure/cable,
/obj/machinery/atmospherics/pipe/smart/simple/supply/hidden/layer4{
	dir = 6
	},
/obj/machinery/atmospherics/pipe/smart/simple/scrubbers/hidden/layer2{
	dir = 6
	},
/turf/open/floor/plating,
/area/station)
"rG" = (
/obj/structure/table,
/obj/effect/turf_decal/tile/dark/opposingcorners,
/obj/item/clothing/glasses/sunglasses,
/obj/item/storage/briefcase/lawyer{
	pixel_y = 9
	},
/obj/item/storage/briefcase{
	pixel_y = 1
	},
/turf/open/floor/iron/dark,
/area/station)
"rH" = (
/obj/structure/table,
/obj/item/newspaper,
/turf/open/floor/iron/dark,
/area/station)
"rX" = (
/obj/structure/chair/office{
	dir = 1
	},
/turf/open/floor/wood,
/area/station)
"si" = (
/obj/structure/table/wood,
/turf/open/floor/wood,
/area/station)
"sF" = (
/obj/effect/turf_decal/tile/neutral/fourcorners,
/obj/machinery/door/airlock/security/glass,
/turf/open/floor/iron/dark,
/area/station)
"tt" = (
/obj/structure/chair/office,
/turf/open/floor/wood,
/area/station)
"ug" = (
/obj/structure/railing{
	dir = 4
	},
/obj/effect/turf_decal/tile/neutral/fourcorners,
/turf/open/floor/iron/dark,
/area/station)
"uR" = (
/obj/machinery/power/smes/magical,
/obj/structure/cable,
/turf/open/floor/iron/dark,
/area/station)
"vu" = (
/obj/machinery/light/cold/directional/east,
/turf/open/floor/iron/dark,
/area/station)
"vv" = (
/obj/structure/reagent_dispensers/watertank,
/turf/open/floor/plating,
/area/station)
"vR" = (
/obj/structure/reagent_dispensers/fueltank,
/turf/open/floor/plating,
/area/station)
"wk" = (
/obj/effect/spawner/structure/window/reinforced,
/turf/open/floor/plating,
/area/station)
"wG" = (
/obj/structure/disposalpipe/segment{
	dir = 10
	},
/turf/open/floor/plating,
/area/station)
"wQ" = (
/obj/structure/table/wood,
/obj/machinery/computer/security/telescreen/prison{
	pixel_y = 2
	},
/turf/open/floor/wood,
/area/station)
"xf" = (
/obj/effect/turf_decal/tile/dark/opposingcorners,
/obj/effect/landmark/start/lawyer,
/turf/open/floor/iron/dark,
/area/station)
"xH" = (
/obj/structure/closet/firecloset,
/turf/open/floor/plating,
/area/station)
"xY" = (
/obj/structure/table/wood,
/obj/item/folder/documents,
/turf/open/floor/wood,
/area/station)
"yC" = (
/obj/effect/turf_decal/tile/dark/opposingcorners,
/obj/machinery/disposal/bin,
/obj/effect/turf_decal/bot_white,
/turf/open/floor/iron/dark,
/area/station)
"yR" = (
/obj/structure/chair/sofa/corp/right,
/turf/open/floor/iron/dark,
/area/station)
"zD" = (
/obj/effect/turf_decal/tile/dark/opposingcorners,
/obj/machinery/light/warm/directional/south,
/obj/structure/hedge,
/turf/open/floor/iron/dark,
/area/station)
"zZ" = (
/obj/structure/railing,
/obj/machinery/atmospherics/pipe/smart/simple/supply/hidden/layer4,
/obj/machinery/atmospherics/pipe/smart/simple/scrubbers/hidden/layer2,
/obj/structure/cable,
/turf/open/floor/plating,
/area/station)
"CQ" = (
/obj/structure/cable,
/turf/open/floor/iron/dark,
/area/station)
"CY" = (
/obj/machinery/door/airlock/maintenance,
/turf/open/floor/plating,
/area/station)
"DA" = (
/turf/open/space/basic,
/area/space)
"FO" = (
/turf/closed/wall,
/area/station)
"Hs" = (
/obj/effect/turf_decal/tile/dark/opposingcorners,
/obj/item/radio/intercom/prison/directional/west,
/turf/open/floor/iron/dark,
/area/station)
"Hx" = (
/turf/open/floor/iron/dark,
/area/station)
"HD" = (
/obj/structure/rack,
/obj/item/storage/toolbox/mechanical,
/turf/open/floor/iron/dark/smooth_large,
/area/station)
"Im" = (
/obj/machinery/light/small/directional/south,
/turf/open/floor/plating,
/area/station)
"IB" = (
/obj/effect/turf_decal/tile/dark/opposingcorners,
/turf/open/floor/iron/dark,
/area/station)
"IM" = (
/obj/structure/window/reinforced/spawner/directional/east,
/turf/open/floor/wood,
/area/station)
"JF" = (
/obj/structure/chair/sofa/corp/left,
/turf/open/floor/iron/dark,
/area/station)
"LP" = (
/obj/machinery/light/warm/directional/south,
/turf/open/floor/iron/dark/smooth_large,
/area/station)
"Nw" = (
/obj/structure/table/wood,
/obj/item/flashlight/lamp/green{
	pixel_x = 4;
	pixel_y = 11
	},
/turf/open/floor/wood,
/area/station)
"PR" = (
/obj/machinery/suit_storage_unit/open,
/turf/open/floor/iron/dark/smooth_large,
/area/station)
"Qe" = (
/turf/open/floor/plating,
/area/station)
"SC" = (
/obj/structure/tank_dispenser/oxygen,
/turf/open/floor/iron/dark/smooth_large,
/area/station)
"SP" = (
/obj/structure/chair/office{
	dir = 4
	},
/obj/effect/landmark/start/lawyer,
/turf/open/floor/wood,
/area/station)
"Ta" = (
/obj/structure/cable,
/obj/machinery/atmospherics/pipe/smart/simple/scrubbers/hidden/layer2,
/obj/machinery/atmospherics/pipe/smart/simple/supply/hidden/layer4,
/obj/structure/disposalpipe/segment,
/obj/structure/lattice/catwalk,
/turf/open/openspace,
/area/station)
"Tz" = (
/obj/machinery/power/terminal{
	dir = 8
	},
/turf/open/floor/iron/dark,
/area/station)
"TM" = (
/obj/machinery/fax{
	fax_name = "Law Office";
	name = "Law Office Fax Machine";
	pixel_y = 10
	},
/obj/structure/table,
/obj/effect/turf_decal/tile/dark/opposingcorners,
/turf/open/floor/iron/dark,
/area/station)
"TO" = (
/obj/machinery/light/small/directional/west,
/turf/open/floor/iron/dark,
/area/station)
"Vv" = (
/obj/machinery/power/apc/auto_name/directional/north,
/obj/structure/cable,
/turf/open/floor/iron/dark,
/area/station)
"Vx" = (
/obj/structure/table/wood,
/obj/item/paper_bin{
	pixel_y = 6
	},
/obj/item/pen{
	pixel_y = 7
	},
/turf/open/floor/wood,
/area/station)
"VI" = (
/turf/open/floor/wood,
/area/station)
"Wg" = (
/obj/machinery/gravity_generator/main,
/turf/open/floor/iron/dark,
/area/station)
"Wx" = (
/obj/machinery/light/floor,
/turf/open/floor/iron/dark,
/area/station)
"WK" = (
/obj/machinery/vending/wardrobe/law_wardrobe,
/obj/effect/turf_decal/tile/dark/opposingcorners,
/turf/open/floor/iron/dark,
/area/station)
"Xn" = (
/obj/effect/spawner/structure/window/reinforced,
/obj/machinery/door/poddoor/shutters/preopen{
	id = "lawyerprivacy";
	name = "Lawyer's Privacy Shutter";
	dir = 4
	},
/turf/open/floor/plating,
/area/station)
"XP" = (
/obj/machinery/light/small/directional/west,
/turf/open/floor/plating,
/area/station)
"YI" = (
/obj/machinery/light/small/red/directional/west,
/turf/open/floor/plating,
/area/station)

(1,1,1) = {"
DA
DA
DA
DA
DA
DA
DA
DA
DA
DA
DA
DA
DA
DA
DA
DA
DA
DA
DA
DA
DA
DA
DA
DA
DA
DA
DA
DA
DA
DA
DA
DA
DA
DA
DA
DA
DA
DA
DA
DA
"}
(2,1,1) = {"
DA
DA
DA
DA
DA
DA
DA
DA
DA
DA
DA
DA
DA
DA
DA
DA
DA
DA
DA
DA
DA
DA
DA
DA
DA
DA
DA
DA
DA
DA
DA
DA
DA
DA
DA
DA
DA
DA
DA
DA
"}
(3,1,1) = {"
DA
DA
DA
DA
DA
DA
DA
DA
DA
DA
DA
DA
DA
DA
DA
DA
DA
DA
DA
DA
DA
DA
DA
DA
DA
DA
DA
DA
DA
DA
DA
DA
DA
DA
DA
DA
DA
DA
DA
DA
"}
(4,1,1) = {"
DA
DA
DA
DA
DA
DA
DA
DA
DA
DA
DA
DA
DA
DA
DA
DA
DA
DA
DA
DA
DA
DA
DA
DA
DA
DA
DA
DA
DA
DA
DA
DA
DA
DA
DA
DA
DA
DA
DA
DA
"}
(5,1,1) = {"
DA
DA
DA
DA
DA
DA
DA
DA
DA
DA
DA
DA
DA
DA
DA
DA
DA
DA
DA
DA
DA
DA
DA
DA
DA
DA
DA
DA
DA
DA
DA
DA
DA
DA
DA
DA
DA
DA
DA
DA
"}
(6,1,1) = {"
DA
DA
DA
DA
DA
DA
DA
DA
DA
DA
DA
DA
DA
DA
DA
DA
DA
DA
DA
DA
DA
DA
DA
DA
DA
DA
DA
DA
DA
DA
DA
DA
DA
DA
DA
DA
DA
DA
DA
DA
"}
(7,1,1) = {"
DA
DA
DA
DA
DA
DA
DA
DA
DA
DA
DA
DA
DA
DA
DA
DA
DA
DA
DA
DA
DA
DA
DA
DA
DA
DA
DA
DA
DA
DA
DA
DA
DA
DA
DA
DA
DA
DA
DA
DA
"}
(8,1,1) = {"
DA
DA
DA
DA
DA
DA
DA
DA
DA
DA
DA
DA
DA
DA
DA
DA
DA
DA
DA
DA
DA
DA
DA
DA
DA
DA
DA
DA
DA
DA
DA
DA
DA
DA
DA
DA
DA
DA
DA
DA
"}
(9,1,1) = {"
DA
DA
DA
DA
DA
DA
DA
DA
DA
DA
DA
DA
DA
DA
DA
DA
DA
DA
DA
DA
DA
DA
DA
DA
DA
DA
DA
DA
DA
DA
DA
DA
DA
DA
DA
DA
DA
DA
DA
DA
"}
(10,1,1) = {"
DA
DA
DA
DA
DA
DA
DA
DA
DA
DA
DA
DA
DA
DA
DA
DA
DA
DA
DA
DA
DA
DA
DA
DA
DA
DA
DA
DA
DA
DA
DA
DA
DA
DA
DA
DA
DA
DA
DA
DA
"}
(11,1,1) = {"
DA
DA
DA
DA
DA
DA
DA
DA
DA
DA
DA
DA
DA
DA
DA
DA
DA
DA
DA
DA
DA
DA
DA
DA
DA
DA
DA
DA
DA
DA
DA
DA
DA
DA
DA
DA
DA
DA
DA
DA
"}
(12,1,1) = {"
DA
DA
DA
DA
DA
DA
DA
DA
DA
DA
DA
DA
DA
DA
FO
FO
FO
FO
FO
FO
FO
FO
FO
FO
FO
FO
FO
FO
FO
FO
DA
DA
DA
DA
DA
DA
DA
DA
DA
DA
"}
(13,1,1) = {"
DA
DA
DA
DA
DA
DA
DA
DA
DA
FO
FO
FO
FO
FO
FO
Qe
Qe
Qe
Qe
Qe
Qe
Qe
Qe
Qe
Qe
Qe
Qe
ns
ci
FO
DA
DA
DA
DA
DA
DA
DA
DA
DA
DA
"}
(14,1,1) = {"
DA
DA
DA
DA
DA
DA
DA
DA
DA
FO
Qe
Qe
Qe
Qe
Qe
Qe
Qe
Qe
Qe
Wx
Hx
Hx
Hx
Wx
Qe
Qe
Qe
Qe
ns
FO
DA
DA
DA
DA
DA
DA
DA
DA
DA
DA
"}
(15,1,1) = {"
DA
DA
DA
DA
DA
DA
DA
DA
DA
FO
Qe
Qe
Qe
Qe
Qe
Qe
Qe
Qe
Qe
Hx
Hx
Hx
Hx
Hx
Qe
Qe
Qe
Qe
Qe
FO
DA
DA
DA
DA
DA
DA
DA
DA
DA
DA
"}
(16,1,1) = {"
DA
DA
DA
DA
DA
DA
DA
DA
DA
FO
Qe
Qe
Qe
Qe
Qe
Qe
Qe
Qe
Qe
Hx
Hx
Hx
Wg
Hx
Qe
Qe
Qe
Qe
Qe
FO
DA
DA
DA
DA
DA
DA
DA
DA
DA
DA
"}
(17,1,1) = {"
DA
DA
DA
DA
DA
DA
DA
DA
DA
FO
Qe
Qe
Qe
Qe
Qe
Qe
Qe
Qe
Qe
Hx
Hx
Hx
Hx
Hx
Qe
Qe
Qe
Qe
Qe
FO
DA
DA
DA
DA
DA
DA
DA
DA
DA
DA
"}
(18,1,1) = {"
DA
DA
DA
DA
DA
DA
DA
DA
DA
FO
Qe
Qe
Qe
Qe
Qe
Qe
Qe
Qe
Qe
Wx
Hx
Hx
Hx
Wx
Qe
Qe
Qe
Qe
Qe
FO
DA
DA
DA
DA
DA
DA
DA
DA
DA
DA
"}
(19,1,1) = {"
DA
DA
DA
DA
DA
DA
DA
DA
DA
FO
Qe
Qe
Qe
Qe
Qe
Qe
Qe
Qe
Qe
Qe
Qe
Qe
Qe
Qe
Qe
Qe
Qe
Qe
Qe
FO
DA
DA
DA
DA
DA
DA
DA
DA
DA
DA
"}
(20,1,1) = {"
DA
DA
DA
DA
DA
DA
DA
DA
DA
FO
FO
FO
FO
FO
FO
FO
FO
FO
Qe
Qe
Qe
Qe
Qe
Qe
Qe
Qe
FO
FO
FO
FO
DA
DA
DA
DA
DA
DA
DA
DA
DA
DA
"}
(21,1,1) = {"
DA
DA
DA
DA
DA
DA
DA
DA
DA
FO
Hx
Hx
Hx
Hx
Hx
Hx
Hx
FO
Qe
Qe
Qe
Qe
Qe
Qe
Qe
Qe
FO
Hx
Hx
FO
DA
DA
DA
DA
DA
DA
DA
DA
DA
DA
"}
(22,1,1) = {"
DA
DA
DA
DA
DA
DA
DA
DA
DA
FO
Hx
Hx
Hx
Hx
Hx
Hx
Hx
FO
FO
FO
FO
FO
FO
FO
FO
FO
FO
Hx
Hx
FO
DA
DA
DA
DA
DA
DA
DA
DA
DA
DA
"}
(23,1,1) = {"
DA
DA
DA
DA
DA
DA
DA
DA
DA
FO
Hx
Hx
Hx
Hx
Hx
Hx
Hx
Hx
Hx
Hx
Hx
Hx
Hx
Hx
Hx
Hx
Hx
Hx
Hx
FO
DA
DA
DA
DA
DA
DA
DA
DA
DA
DA
"}
(24,1,1) = {"
DA
DA
DA
DA
DA
DA
DA
DA
DA
FO
Hx
pw
pw
pw
pw
pw
pw
pw
pw
pw
pw
pw
pw
pw
pw
pw
pw
pw
Hx
FO
DA
DA
DA
DA
DA
DA
DA
DA
DA
DA
"}
(25,1,1) = {"
DA
DA
DA
DA
DA
DA
DA
DA
DA
FO
Hx
Hx
Hx
Hx
Hx
Hx
Hx
Hx
vu
Hx
Hx
Hx
Hx
Hx
Hx
vu
Hx
Hx
Hx
FO
DA
DA
DA
DA
DA
DA
DA
DA
DA
DA
"}
(26,1,1) = {"
DA
DA
DA
DA
DA
DA
DA
DA
DA
FO
FO
FO
FO
FO
FO
FO
FO
FO
FO
FO
FO
FO
FO
FO
FO
FO
FO
FO
FO
FO
DA
DA
DA
DA
DA
DA
DA
DA
DA
DA
"}
(27,1,1) = {"
DA
DA
DA
DA
DA
DA
DA
DA
DA
FO
Qe
Qe
Qe
Qe
Qe
Qe
Qe
Qe
Qe
Qe
Qe
Qe
Qe
Qe
Qe
Qe
Qe
Qe
Qe
FO
DA
DA
DA
DA
DA
DA
DA
DA
DA
DA
"}
(28,1,1) = {"
DA
DA
DA
DA
DA
DA
DA
DA
DA
FO
Qe
Qe
Qe
Qe
Qe
Qe
Qe
Qe
Qe
Qe
Qe
Qe
Qe
Qe
Qe
Qe
Qe
Qe
Qe
FO
DA
DA
DA
DA
DA
DA
DA
DA
DA
DA
"}
(29,1,1) = {"
DA
DA
DA
DA
DA
DA
DA
DA
DA
FO
FO
FO
FO
FO
FO
FO
FO
FO
FO
FO
FO
FO
FO
FO
FO
FO
FO
FO
FO
FO
DA
DA
DA
DA
DA
DA
DA
DA
DA
DA
"}
(30,1,1) = {"
DA
DA
DA
DA
DA
DA
DA
DA
DA
DA
DA
DA
DA
DA
DA
DA
DA
DA
DA
DA
DA
DA
DA
DA
DA
DA
DA
DA
DA
DA
DA
DA
DA
DA
DA
DA
DA
DA
DA
DA
"}
(31,1,1) = {"
DA
DA
DA
DA
DA
DA
DA
DA
DA
DA
DA
DA
DA
DA
DA
DA
DA
DA
DA
DA
DA
DA
DA
DA
DA
DA
DA
DA
DA
DA
DA
DA
DA
DA
DA
DA
DA
DA
DA
DA
"}
(32,1,1) = {"
DA
DA
DA
DA
DA
DA
DA
DA
DA
DA
DA
DA
DA
DA
DA
DA
DA
DA
DA
DA
DA
DA
DA
DA
DA
DA
DA
DA
DA
DA
DA
DA
DA
DA
DA
DA
DA
DA
DA
DA
"}
(33,1,1) = {"
DA
DA
DA
DA
DA
DA
DA
DA
DA
DA
DA
DA
DA
DA
DA
DA
DA
DA
DA
DA
DA
DA
DA
DA
DA
DA
DA
DA
DA
DA
DA
DA
DA
DA
DA
DA
DA
DA
DA
DA
"}
(34,1,1) = {"
DA
DA
DA
DA
DA
DA
DA
DA
DA
DA
DA
DA
DA
DA
DA
DA
DA
DA
DA
DA
DA
DA
DA
DA
DA
DA
DA
DA
DA
DA
DA
DA
DA
DA
DA
DA
DA
DA
DA
DA
"}
(35,1,1) = {"
DA
DA
DA
DA
DA
DA
DA
DA
DA
DA
DA
DA
DA
DA
DA
DA
DA
DA
DA
DA
DA
DA
DA
DA
DA
DA
DA
DA
DA
DA
DA
DA
DA
DA
DA
DA
DA
DA
DA
DA
"}
(36,1,1) = {"
DA
DA
DA
DA
DA
DA
DA
DA
DA
DA
DA
DA
DA
DA
DA
DA
DA
DA
DA
DA
DA
DA
DA
DA
DA
DA
DA
DA
DA
DA
DA
DA
DA
DA
DA
DA
DA
DA
DA
DA
"}
(37,1,1) = {"
DA
DA
DA
DA
DA
DA
DA
DA
DA
DA
DA
DA
DA
DA
DA
DA
DA
DA
DA
DA
DA
DA
DA
DA
DA
DA
DA
DA
DA
DA
DA
DA
DA
DA
DA
DA
DA
DA
DA
DA
"}
(38,1,1) = {"
DA
DA
DA
DA
DA
DA
DA
DA
DA
DA
DA
DA
DA
DA
DA
DA
DA
DA
DA
DA
DA
DA
DA
DA
DA
DA
DA
DA
DA
DA
DA
DA
DA
DA
DA
DA
DA
DA
DA
DA
"}
(39,1,1) = {"
DA
DA
DA
DA
DA
DA
DA
DA
DA
DA
DA
DA
DA
DA
DA
DA
DA
DA
DA
DA
DA
DA
DA
DA
DA
DA
DA
DA
DA
DA
DA
DA
DA
DA
DA
DA
DA
DA
DA
DA
"}
(40,1,1) = {"
DA
DA
DA
DA
DA
DA
DA
DA
DA
DA
DA
DA
DA
DA
DA
DA
DA
DA
DA
DA
DA
DA
DA
DA
DA
DA
DA
DA
DA
DA
DA
DA
DA
DA
DA
DA
DA
DA
DA
DA
"}

(1,1,2) = {"
DA
DA
DA
DA
DA
DA
DA
DA
DA
DA
DA
DA
DA
DA
DA
DA
DA
DA
DA
DA
DA
DA
DA
DA
DA
DA
DA
DA
DA
DA
DA
DA
DA
DA
DA
DA
DA
DA
DA
DA
"}
(2,1,2) = {"
DA
DA
DA
DA
DA
DA
DA
DA
DA
DA
DA
DA
DA
DA
DA
DA
DA
DA
DA
DA
DA
DA
DA
DA
DA
DA
DA
DA
DA
DA
DA
DA
DA
DA
DA
DA
DA
DA
DA
DA
"}
(3,1,2) = {"
DA
DA
DA
DA
DA
DA
DA
DA
DA
DA
DA
DA
DA
DA
DA
DA
DA
DA
DA
DA
DA
DA
DA
DA
DA
DA
DA
DA
DA
DA
DA
DA
DA
DA
DA
DA
DA
DA
DA
DA
"}
(4,1,2) = {"
DA
DA
DA
DA
DA
DA
DA
DA
DA
DA
DA
DA
DA
DA
DA
DA
DA
DA
DA
DA
DA
DA
DA
DA
DA
DA
DA
DA
DA
DA
DA
DA
DA
DA
DA
DA
DA
DA
DA
DA
"}
(5,1,2) = {"
DA
DA
DA
DA
DA
DA
DA
DA
DA
DA
DA
DA
DA
DA
DA
DA
DA
DA
DA
DA
DA
DA
DA
DA
DA
DA
DA
DA
DA
DA
DA
DA
DA
DA
DA
DA
DA
DA
DA
DA
"}
(6,1,2) = {"
DA
DA
DA
DA
DA
DA
DA
DA
DA
DA
DA
DA
DA
DA
DA
DA
DA
DA
DA
DA
DA
DA
DA
DA
DA
DA
DA
DA
DA
DA
DA
DA
DA
DA
DA
DA
DA
DA
DA
DA
"}
(7,1,2) = {"
DA
DA
DA
DA
DA
DA
DA
DA
DA
DA
DA
DA
DA
DA
DA
DA
DA
DA
DA
DA
DA
DA
DA
DA
DA
DA
DA
DA
DA
DA
DA
DA
DA
DA
DA
DA
DA
DA
DA
DA
"}
(8,1,2) = {"
DA
DA
DA
DA
DA
DA
DA
DA
DA
DA
DA
DA
DA
DA
DA
DA
DA
DA
DA
DA
DA
DA
DA
DA
DA
DA
DA
DA
DA
DA
DA
DA
DA
DA
DA
DA
DA
DA
DA
DA
"}
(9,1,2) = {"
DA
DA
DA
DA
DA
DA
DA
FO
FO
FO
FO
FO
FO
FO
FO
FO
FO
FO
DA
DA
DA
DA
DA
DA
DA
DA
DA
DA
DA
DA
DA
DA
DA
DA
DA
DA
DA
DA
DA
DA
"}
(10,1,2) = {"
DA
DA
DA
DA
DA
DA
DA
FO
HD
PR
PR
FO
jq
jq
sF
eg
eg
FO
DA
DA
DA
DA
DA
DA
DA
DA
DA
DA
DA
DA
DA
DA
DA
DA
DA
DA
DA
DA
DA
DA
"}
(11,1,2) = {"
DA
DA
DA
DA
DA
DA
DA
wk
SC
jq
jq
sF
jq
LP
FO
jq
jq
FO
DA
DA
DA
DA
DA
DA
DA
DA
DA
DA
DA
DA
DA
DA
DA
DA
DA
DA
DA
DA
DA
DA
"}
(12,1,2) = {"
DA
DA
DA
DA
DA
DA
DA
FO
FO
PR
PR
FO
ak
ak
FO
CY
FO
FO
FO
FO
FO
FO
FO
FO
FO
FO
FO
FO
FO
FO
DA
DA
DA
DA
DA
DA
DA
DA
DA
DA
"}
(13,1,2) = {"
DA
DA
DA
DA
DA
DA
DA
DA
hp
FO
FO
FO
FO
FO
FO
eg
eg
FO
lm
cL
Qe
YI
Qe
Qe
Qe
Qe
Qe
ns
ci
FO
DA
DA
DA
DA
DA
DA
DA
DA
DA
DA
"}
(14,1,2) = {"
DA
DA
DA
DA
DA
DA
DA
DA
DA
FO
Hx
Hx
Hx
TO
Hx
Hx
Hx
FO
lm
cL
Qe
Qe
Qe
Qe
Qe
Qe
Qe
Qe
ns
FO
DA
DA
DA
DA
DA
DA
DA
DA
DA
DA
"}
(15,1,2) = {"
DA
DA
DA
DA
DA
DA
DA
DA
DA
FO
pw
pw
pw
pw
pw
pw
pw
FO
FO
FO
CY
FO
FO
FO
FO
FO
FO
Hx
Hx
FO
DA
DA
DA
DA
DA
DA
DA
DA
DA
DA
"}
(16,1,2) = {"
DA
DA
DA
DA
DA
DA
DA
DA
DA
FO
CY
FO
FO
FO
FO
mQ
mQ
FO
yC
Hs
IB
ou
FO
qz
da
TM
FO
Vv
Hx
FO
DA
DA
DA
DA
DA
DA
DA
DA
DA
DA
"}
(17,1,2) = {"
DA
DA
DA
DA
DA
DA
DA
DA
DA
FO
Qe
Qe
vR
vv
FO
rH
pw
ej
IB
IB
IB
mw
FO
WK
xf
rG
FO
CQ
Hx
FO
DA
DA
DA
DA
DA
DA
DA
DA
DA
DA
"}
(18,1,2) = {"
DA
DA
DA
DA
DA
DA
DA
DA
DA
FO
Qe
Qe
Qe
Im
FO
yR
pw
hs
IB
ca
IB
zD
FO
kx
IB
kx
FO
uR
Hx
FO
DA
DA
DA
DA
DA
DA
DA
DA
DA
DA
"}
(19,1,2) = {"
DA
DA
DA
DA
DA
DA
DA
DA
DA
FO
Qe
Qe
mY
xH
FO
JF
pw
FO
bn
IM
VI
VI
iT
VI
VI
VI
FO
Tz
Hx
FO
DA
DA
DA
DA
DA
DA
DA
DA
DA
DA
"}
(20,1,2) = {"
DA
DA
DA
DA
DA
DA
DA
DA
DA
FO
lp
FO
FO
FO
FO
pW
ug
FO
md
VI
VI
VI
tt
xY
SP
VI
FO
wk
wk
FO
DA
DA
DA
DA
DA
DA
DA
DA
DA
DA
"}
(21,1,2) = {"
DA
DA
DA
DA
DA
DA
DA
DA
DA
FO
bJ
fj
lm
lm
lm
lm
lm
FO
wQ
rX
ir
jc
tt
si
Nw
Vx
FO
lm
lm
FO
DA
DA
DA
DA
DA
DA
DA
DA
DA
DA
"}
(22,1,2) = {"
DA
DA
DA
DA
DA
DA
DA
DA
DA
FO
bJ
fj
lm
lm
lm
lm
lm
FO
Xn
Xn
FO
Xn
Xn
FO
Xn
Xn
FO
lm
lm
FO
DA
DA
DA
DA
DA
DA
DA
DA
DA
DA
"}
(23,1,2) = {"
DA
DA
DA
DA
DA
DA
DA
DA
DA
FO
wG
nG
jt
jt
jt
jt
jt
jt
jt
jt
jt
jt
jt
jt
jt
jt
jt
jt
jt
FO
DA
DA
DA
DA
DA
DA
DA
DA
DA
DA
"}
(24,1,2) = {"
DA
DA
DA
DA
DA
DA
DA
DA
DA
FO
Qe
fj
lm
lm
lm
lm
lm
lm
mN
lm
lm
lm
lm
lm
lm
mN
lm
lm
lm
FO
DA
DA
DA
DA
DA
DA
DA
DA
DA
DA
"}
(25,1,2) = {"
DA
DA
DA
DA
DA
DA
DA
DA
DA
FO
rE
zZ
Ta
Ta
Ta
Ta
Ta
Ta
Ta
Ta
Ta
Ta
Ta
Ta
Ta
Ta
Ta
Ta
Ta
FO
DA
DA
DA
DA
DA
DA
DA
DA
DA
DA
"}
(26,1,2) = {"
DA
DA
DA
DA
DA
DA
DA
DA
DA
FO
gH
FO
FO
FO
FO
FO
FO
FO
FO
FO
FO
FO
FO
FO
FO
FO
FO
FO
FO
FO
DA
DA
DA
DA
DA
DA
DA
DA
DA
DA
"}
(27,1,2) = {"
DA
DA
DA
DA
DA
DA
DA
DA
DA
FO
iU
Qe
Qe
Qe
Qe
Qe
XP
Qe
Qe
Qe
Qe
Qe
XP
Qe
Qe
Qe
Qe
Qe
XP
FO
DA
DA
DA
DA
DA
DA
DA
DA
DA
DA
"}
(28,1,2) = {"
DA
DA
DA
DA
DA
DA
DA
DA
DA
FO
Qe
Qe
Qe
Qe
Qe
Qe
Qe
Qe
Qe
Qe
Qe
Qe
Qe
Qe
Qe
Qe
Qe
Qe
Qe
FO
DA
DA
DA
DA
DA
DA
DA
DA
DA
DA
"}
(29,1,2) = {"
DA
DA
DA
DA
DA
DA
DA
DA
DA
FO
FO
FO
wk
wk
wk
FO
FO
FO
wk
wk
wk
FO
FO
FO
wk
wk
wk
FO
FO
FO
DA
DA
DA
DA
DA
DA
DA
DA
DA
DA
"}
(30,1,2) = {"
DA
DA
DA
DA
DA
DA
DA
DA
DA
DA
DA
DA
DA
DA
DA
DA
DA
DA
DA
DA
DA
DA
DA
DA
DA
DA
DA
DA
DA
DA
DA
DA
DA
DA
DA
DA
DA
DA
DA
DA
"}
(31,1,2) = {"
DA
DA
DA
DA
DA
DA
DA
DA
DA
DA
DA
DA
DA
DA
DA
DA
DA
DA
DA
DA
DA
DA
DA
DA
DA
DA
DA
DA
DA
DA
DA
DA
DA
DA
DA
DA
DA
DA
DA
DA
"}
(32,1,2) = {"
DA
DA
DA
DA
DA
DA
DA
DA
DA
DA
DA
DA
DA
DA
DA
DA
DA
DA
DA
DA
DA
DA
DA
DA
DA
DA
DA
DA
DA
DA
DA
DA
DA
DA
DA
DA
DA
DA
DA
DA
"}
(33,1,2) = {"
DA
DA
DA
DA
DA
DA
DA
DA
DA
DA
DA
DA
DA
DA
DA
DA
DA
DA
DA
DA
DA
DA
DA
DA
DA
DA
DA
DA
DA
DA
DA
DA
DA
DA
DA
DA
DA
DA
DA
DA
"}
(34,1,2) = {"
DA
DA
DA
DA
DA
DA
DA
DA
DA
DA
DA
DA
DA
DA
DA
DA
DA
DA
DA
DA
DA
DA
DA
DA
DA
DA
DA
DA
DA
DA
DA
DA
DA
DA
DA
DA
DA
DA
DA
DA
"}
(35,1,2) = {"
DA
DA
DA
DA
DA
DA
DA
DA
DA
DA
DA
DA
DA
DA
DA
DA
DA
DA
DA
DA
DA
DA
DA
DA
DA
DA
DA
DA
DA
DA
DA
DA
DA
DA
DA
DA
DA
DA
DA
DA
"}
(36,1,2) = {"
DA
DA
DA
DA
DA
DA
DA
DA
DA
DA
DA
DA
DA
DA
DA
DA
DA
DA
DA
DA
DA
DA
DA
DA
DA
DA
DA
DA
DA
DA
DA
DA
DA
DA
DA
DA
DA
DA
DA
DA
"}
(37,1,2) = {"
DA
DA
DA
DA
DA
DA
DA
DA
DA
DA
DA
DA
DA
DA
DA
DA
DA
DA
DA
DA
DA
DA
DA
DA
DA
DA
DA
DA
DA
DA
DA
DA
DA
DA
DA
DA
DA
DA
DA
DA
"}
(38,1,2) = {"
DA
DA
DA
DA
DA
DA
DA
DA
DA
DA
DA
DA
DA
DA
DA
DA
DA
DA
DA
DA
DA
DA
DA
DA
DA
DA
DA
DA
DA
DA
DA
DA
DA
DA
DA
DA
DA
DA
DA
DA
"}
(39,1,2) = {"
DA
DA
DA
DA
DA
DA
DA
DA
DA
DA
DA
DA
DA
DA
DA
DA
DA
DA
DA
DA
DA
DA
DA
DA
DA
DA
DA
DA
DA
DA
DA
DA
DA
DA
DA
DA
DA
DA
DA
DA
"}
(40,1,2) = {"
DA
DA
DA
DA
DA
DA
DA
DA
DA
DA
DA
DA
DA
DA
DA
DA
DA
DA
DA
DA
DA
DA
DA
DA
DA
DA
DA
DA
DA
DA
DA
DA
DA
DA
DA
DA
DA
DA
DA
DA
"}
